00000000000000020000000000000000
00000000000000020000000000000000
00000000000000020000000000000000
00000000000000020000000000000000
00000000000000000000000000000000
11111111111111001111111111111111
00000000000000000000000000000000
00000000000000000000000000000000
11111111111111001111111111111111
00000000000000020000000000000000
00000000000000020000000000000000
00000000000000020000000000000000
00000000000000020000000000000000
00000000000000020000000000000000
